{
  "name": "综合挑战15x15",
  "maze": [
    ["#", "#", "#", "#", "#", "#", "#", "#", "#", "#", "#", "#", "#", "#", "#"],
    ["#", "S", "#", " ", "#", " ", "#", " ", "#", " ", " ", " ", " ", " ", "#"],
    ["#", " ", "#", " ", "#", " ", "#", " ", "#", "#", "#", " ", "#", "#", "#"],
    ["#", " ", "#", " ", " ", " ", "#", " ", "#", " ", " ", " ", "#", " ", "#"],
    ["#", " ", "#", "G", "#", "#", "#", " ", "#", " ", "#", "#", "#", " ", "#"],
    ["#", " ", " ", " ", "#", " ", "G", " ", " ", " ", " ", " ", "#", " ", "#"],
    ["#", "#", "#", " ", "#", " ", "#", "#", "#", " ", "#", "#", "#", " ", "#"],
    ["#", " ", " ", "T", "G", " ", "B", " ", "#", " ", " ", " ", " ", " ", "#"],
    ["#", " ", "#", "#", "#", "#", "#", "#", "#", " ", "#", " ", "#", " ", "#"],
    ["#", " ", " ", " ", "#", " ", "#", " ", "#", " ", "#", " ", "#", " ", "#"],
    ["#", "#", "#", "#", "#", " ", "#", " ", "#", "#", "#", "#", "#", " ", "#"],
    ["#", " ", " ", "G", " ", "G", " ", " ", "#", " ", " ", " ", " ", " ", "#"],
    ["#", " ", "#", "#", "#", " ", "#", " ", "#", "#", "#", " ", "#", "#", "#"],
    ["#", "G", " ", " ", "#", " ", "#", " ", " ", "G", " ", "B", " ", "E", "#"],
    ["#", "#", "#", "#", "#", "#", "#", "#", "#", "#", "#", "#", "#", "#", "#"]
  ],
  "B": [36, 25],
  "PlayerSkills": [[8, 4], [2, 0], [4, 2], [6, 3]],
  "minRouds": 20,
  "CoinConsumption": 7
}
